1111111111111111111111111111111
1E000000000000010000010000000C1
1001111001111001001001001111001
1001C01000001001001000000001001
1001001111001111001111111001111
100100000100V00S000000001001001
1111111001001111001111001001001
1C01001000000001001C01001000001
100S001111111001001001001111001
1001000001001C01000001001001001
1001111001001001001111001001001
1000001000000000001000001000001
10011111110010H1111111111001111
100100000100100000000100000C0C1
1001001001111001111001111111CC1
100000100100S0000C10000000010C1
1001111001001001111001111001001
1001001C0000100100000000100V001
1001001001111001001001111001001
1C010000000010010010010000010P1
1111111111111111111111111111111
