1111111111111111111111111111111
1E01000000000001000001000000001
1111111001111001001001001111001
1001001000001001001000000001001
1001001111001111001111111001111
100100000100V00S000000001001001
1111111001001111001111001001001
1001001000000001001001001000001
100S001111111001001001001111001
1001000001001001000001001001001
1001111001001001001111001001001
1000001000000000001000001000001
10011111110010H1111111111001111
1001000001001000000001000000001
1001001001111001111001111111001
100000100100S000001000000001001
1001111001001001111001111001001
100100100000100100000000100V001
1001001001111001001001111001001
10010000000010010010010000010P1
1111111111111111111111111111111
