1111111111111111111111111111111
1E0000000V0000010000010000000C1
1001111001111001001001001111001
1001C01000001001001000000001001
1001001111001111001111111001111
1001000001000001000000001001001
1111111001001111001111001001001
1C01001000000001001C01001000001
1001001111111001001001001111001
1001000001001001000001001001001
1001111001001001001111001001001
1000001000000000001000001000001
1001110111001H01111111111001111
100100000100100000000100000S001
1001001001111001111001111111001
1000001001000000001000000001001
1001111001001001111001111001001
1001001C00001001000000001001001
1001001001111001001001111001001
1C010000000010010010010000010P1
1111111111111111111111111111111
