111111111111111
10010000000C001
100C01111100101
1P0011E00001101
111111111111111
